#Name	VCF_annotation_field	Directionality	Threshold	Scope	Processing_function
#Conservation
GERP	GERP
phyloP	phyloP
phastCons	phastCons
SiPhy	SiPhy

# Whole Genome
LINSIGHT	linsight_g
ReMM	ReMM
FATHMM-MKL	fathmmMKL
Eigen	Eigen
CADD-Splice	CADDSplice_PHRED
DANN	DANN
CAPICE	CAPICE,CAPICE_ind

# Splicing
SQUIRLS	SQUIRLS_SCORE
HAL	HAL_DIFF
SPIDEX	dpsi_zscore
dbscSNV	ada_score,rf_score
MaxEntScan	MES-SWA_donor_diff,MES-SWA_acceptor_diff
SpliceAI	SpliceAI,SpliceAI_ind
S-CAP	SCAP
TraP	TraP
ConSpliceML	ConSpliceML
MMSplice	mmsplice_deltaPSI
kipoiSplice4	kipoisplice_4
CI-SpliceAI	CI-SpliceAI
Pangolin	Pangolin
SPiP	SPiP
MLCsplice	MLCsplice
AbSplice-DNA	AbSplice_DNA
